- Aggressive Pedestrians: STOPPICKINGONME
- Aggressive Traffic: ALLDRIVERSARECRIMINALS
- Always 9PM: DONTBRINGONTHENIGHT
- Always Midnight:  
- ax Fat: WHOATEALLTHEPIES
- ax Respect: WORSHIPME
- ax Sex Appeal: HELLOLADIES
- Beach Party Mode: LIFESABEACH
- Bike Super Bunny Hops: CJPHONEHOME
- Black Traffic: SOLONGASITSBLACK
- Carnival Mode: CRAZYTOWN
- Cloudy Weather: DULLDULLDAY
- drenaline Mode: TAKEACHILLPILL
- Elvis Mode: BLUESUEDESHOES
- Extra Sunny Weather: TOODAMNHOT
- Floating Cars: BUBBLECARS
- Flying Boats: FLYINGFISH
- Flying Cars: CHITTYCHITTYBANGBANG
- Full Aim in Vehicles: IWANNADRIVEBY
- Full Health, Armor, and $250,000: INEEDSOMEHELP
- Gang Wars: ONLYHOMIESALLOWED
- Green Traffic Lights: DONTTRYANDSTOPME
- Hitman Level for Every Weapon: PROFESSIONALKILLER
- Infinite Health: NOONECANHURTME
- Invincible Car: TOUCHMYCARYOUDIE
- Invisible Cars: WHEELSONLYPLEASE
- Lock Wanted Level: IDOASIPLEASE
- Make All Vehicles Explode: ALLCARSGOBOOM
- Max Muscle: BUFFMEUP
- Max Stamina: ICANGOALLNIGHT
- Max Vehicle Skills: NATURALTALENT
- Minimum Muscle: LEANANDMEAN
- nfinite Lung Capacity: MANFROMATLANTIS
- Nitro Cars: SPEEDFREAK
- No Pedestrians: GHOSTTOWN
- nstant Death: GOODBYECRUELWORLD
- o Hunger: IAMNEVERHUNGRY
- One-Hit Kill Punches: STINGLIKEABEE
- pawn Parachute: LETSGOBASEJUMPING
- Pedestrians Have Weapons: SURROUNDEDBYNUTTERS
- Perfect Handling: STICKLIKEGLUE
- Pimp Mode: LOVECONQUERSALL
- Pink Traffic: PINKISTHENEWCOOL
- Rainy Weather: STAYINANDWATCHTV
- Recruit Civilians with AK-47s: NOONECANSTOPUS
- Recruit Civilians with Pistols: WANNABEINMYGANG
- Recruit Civilians with Rocket Launchers: ROCKETMAYHEM
- Remove Wanted Level: TURNDOWNTHEHEAT
- Rich Traffic: EVERYONEISRICH
- Riot Mode (With Golf Clubs): ROUGHNEIGHBORHOOD
- Riot Mode: STATEOFEMERGENCY
- Rural Mode: HICKSVILLE
- Rural Traffic: EVERYONEISPOOR
- Sandstorm: SANDINMYEARS
- Six-Star Wanted Level: BRINGITON
- Slow Down Gameplay: SLOWITDOWN
- Spawn Bloodring Banger: OLDSPEEDDEMON
- Spawn Caddy: 18HOLES
- Spawn Dozer: ITSALLBULL
- Spawn Hotring Racer Variant: JUSTTRYANDSTOPME
- Spawn Hotring Racer: NOTFORPUBLICROADS
- Spawn Hunter: OHDUDE
- Spawn Hydra: JUMPJET
- Spawn Jetpack: ROCKETMAN
- Spawn Monster Truck: MONSTERMASH
- Spawn Quad: FOURWHEELFUN
- Spawn Rancher: DOUGHNUTHANDICAP
- Spawn Rhino: TIMETOKICKASS
- Spawn Stretch Limo: CELEBRITYSTATUS
- Spawn Stunt Plane: FLYINGTOSTUNT
- Spawn Tanker: HITTHEROADJACK
- Spawn Trashmaster: TRUEGRIME
- Spawn Vortex: IWANTTOHOVER
- Speed Up Gameplay: SPEEDITUP
- Speed Up Time: TIMEJUSTFLIESBY
- Stormy Weather: SCOTTISHSUMMER
- Sunny Weather: PLEASANTLYWARM
- Super Jump: KANGAROO
- Tier 1 Weapons: THUGSARMOURY
- Tier 2 Weapons: PROFESSIONALSKIT
- Tier 3 Weapons: NUTTERSTOYS
- Triad Mode: NINJATOWN
- Unlimited Ammo: FULLCLIP